 サトシが嫌われる理由(人間性・対人関係・その他。)  ・サトシが続役で現在のゲーム男主人公が登場しない（できない）原因になっている。  ・新地方に旅立つ時はピカ以外置いていく（通称リセット）  ・ピカ以外差別  ・小動物フェチ  ・自分から無理やり連れて行ったトオイに逆ギレした鳥頭  ・ロケット団との漫才がウザイ  ・Ｒ団の捕獲した野生ポケにまでケチ付けて強奪する悪党  ・ポケモンが大好きだから！とシンジに説教してシンジの逃がすことを否定してるくせに自分はリセットや飼い殺しを繰り返している偽善者  ・シンジの戦い方（ポケモンを盾にする）を否定するくせに自分は根性とかで無理矢理戦わせる  ・変な正義感を持ちすぎ（ロケット団は何もしなくても悪者）  ・色黒で不細工なうえ、根性馬鹿の鈍感  ・AGの時程では無いが服がダサイ（トランクスのガラは更にダサい）  ・言葉遣いが基本的に悪い（目上が相手でも自分称が俺。）  ・人の物、施設の物でも勝手にいじる  ・トラブルメーカーで器物損壊罪もやらかす  ・ホッペのＺ  ・ぬるい  ・自分の母を未だにママって言うわりに性格や言葉遣いや服装は可愛くない。  ・人に何かをして貰って「ありがとう」「ごめんなさい」など謝罪と感謝の言葉を言わない事が多い  ・コイキング回でヒカリを見下した発言  ・ロケット団に一方的に言いがかりを付けた挙句、謝罪どころか反省の色も見せない  ・転がってきたビリリダマを電気が弱点のキングラーに受け止めさせて 重症を負わせた池沼  ・もう負けを感じて逃げるロケット団に対して わざわざ追い討ちでとどめを刺す鬼畜、ついたあだ名が悪人ハンター（非公式）  ・住み着いている場所に何度もしつこく侵入されて怒っているギャラドスに対して水の中で10万ボルトを喰らわせる鬼畜  ・レンタルポケモンで戦うバトルファクトリーで（元）自分のリザードンでバトルする。ルール無視  ・（DP74話）ライチュウ＆ピチュー使いのトレーナー（名前はショウ）にピカチュウの交換を要求されるが「俺は絶対交換しない」と交換自体を否定したのにヒカリとは交換する  ・何かの大会でケンタロスの交換を断った  ・自分が住んでいる縄張りに無断侵入されて怒っているラグラージを倒す屑  ・オーキドを軽く超越する老害  	neg
 サトシでは出てこないけどピカチュウで出てくる。どうでもよい。  http://find.2ch.net/?STR=%A5%D4%A5%AB%A5%C1%A5%E5%A5%A6&COUNT=10&TYPE=TITLE&BBS=ALL 	neg
 >>324　アブソルさん  わっ！わわっ！！かっこいいなぁ～・・・。  僕もカッコイイポケモンになれるかな？？ 	pos
 >>595  ピカチュウ  努力値全部999  種族値999  とくせい　神秘の守り 	neu
 >>141  青はミリオンヒット記念としてコロコロコミック限定だった  ピカチュウはポケモン映画公開記念   マイナーチェンジはクリスタルからで  エメラルドから第３のパッケージポケモンつかった   今回のＢＷ２と２バージョンにしたのは  ブラックとホワイト２つそれぞれの世界観での物語（マイナーチェンジ）だから 	neu
 >>138  定番の答えは  青の値札（棚に表示してある奴）のポケセンオリジナル。（通販とかで買えるのは黄色い値札）   あと新商品、企画物のポケモンドリームグッズかな。  等身大もいいね。ぬいぐるみ全般がおすすめ。  まぁ、お気に入りグッズが見つかればそれが一番だ。   お菓子はピカチュウの切手の絵の缶入りチョッコクッキーが旨かったｗ  配り用には高いけど。 	pos
 サトシとピカチュウという  ポケモンアニメの看板を外すのは勿体ない   タケシという、キャラが完成されてて  かつスタッフが動かし易いキャラを外すのは勿体ない    変えるのはヒロイン枠と  チビキャラ枠だけでいいよ 	neg
 ミツル「さて、じゃあジムに行こうか」  ポッポ「ミツル!!　僕達にタケシはキツイです。　ちょっと別のﾎﾟｹﾓﾝで挑んだほうが･･･」  ピカシ「心配ないよ。　僕は草結び覚えてるから　イワークなんてイチコロさ!!」  ミツル「そうかい？　ならいこう!!」  ～ジム～  タケシ「お!!　久々のチャレンジャー？」  ミツル「よ・よよ・ろしくおねががが」  ピカシ「(大丈夫なの？)」  タケシ「早速はじめるぞ　いけ!!　イワーク!!」  イワーク「ピカチュウごときが俺に挑むとは･･･素人だな」  ミツル「ピカシ!!　くさむすび!!」  イワーク「何!?　グアアアアア」  タケシ「イワークがこんなあっさり･･･　只者ではないなあの攻撃力･･･」  (注）電気球は攻撃２倍です  ミツル「やったーー!!　タケシ倒したぞー!!」  ピカシ「楽勝だったな～」  タケシ「負けたよ･･･このグレーバッジをうけとってくれ!!」  	neu
 ↑にも関わらず技４つに無理矢理制限してるのが無駄なんだよ。  技増えて少しでも良くなるのであれば増えて欲しいっしょ？  そもそもゲームにはシステムの限界がある。  極端な話、レベル100のピカチュウの10まんボルトがレベル１のイワークに効かないとかの方が変でしょ？ 	neg
 >>690  ポケセンフクオカに客呼びたいだけならフクオカ限定でグラカイ配ればいい話  ポケセンじゃなくて九州新幹線の利用率が芳しくないんだろ   福岡駅で配らないのも限定ピカチュウも新幹線に乗って貰って他の駅に移動させるため  福岡駅で配ったら九州以外から来る客はそこで受け取ってポケセンでグラカイ貰ってハイ終わり 	neg
 ピカチュウは玉持ちだろ  常識的に考えて・・・ 	neu
 なんかアニメじゃミミロルがレギュラー化するらしいな。  これはアニメでミミロップとピカチュウのセクロスが拝めるかもしれませんね 	pos
 ゲンシカイキピカチュウ  白骨化 	neu
 やっぱピカチュウやアチャモとかちびっちいのが動き回るのが楽しい 	pos
 >>904  ミュウツー＜ルカリオ  な辺り、検索数なんて当てにはならない 	neu
 >>625   ピカチュウ先頭でやってるんだけどね…   俺の運がないからかな… 	neg
 以前放送局の再放送で、バトルのときサトシがピカチュウを抱いてモンスターボール  のように放り投げようとしたよね。ああいうの今のアニメじゃ絶対やらない。  動物虐待とかいわれそうだからかもしれないが、アメリカでの放映が決まってから  やたらおとなしくなった印象はぬぐえない。 	neg
 ピカチュウでさえカビゴンを地球投げできるというのに  変な設定付けて使いづらくされると困るわ 	neg
 ピカチュウこいっ！ 	pos
 >>715  0473-7905-8399  フシギソウ出るはずです  お願いします 	neu
 ピカチュウ「梅」 	neu
 ピカチュウがいなかったらポケモンが６代まで続くこともなかった  BW2おもすろい 	pos
 エロガキが居ないピカチュウスレって無いの？ 	neg
 >>852  実際パンクしたぜー･･･ミズゴロウ増殖中に。  ヒンバスを逃がして調整した。  次はラルトスを逃がさなければならないようだ。 	neu
 >>787  サトシとハルカを思い出してしまうな（ｗ  （カップリング抜きにして） 	pos
 ピカチュウギガントフォルム 	neu
 >>494  キッサキのブスってスズナかノゾミかどっちなんだろう   多分前者たとは思うけど 	neg
 赤・緑・FR  すばしっこく はしり まわり せなかのハリと するどいツメでの こうげきが とくい。   青・LG  せなかを まるめると トゲトゲの ボールみたいだ。そのまま ころがって ぶつかってきたり にげたりする。   ピカチュウ  ツメで ひっかくのが とくいだが たたかっているうち おれることも。つぎのひには また のびてくるぞ。   金・HG  ぜんそくりょくで はしりまわって すなけむりを まきあげ じぶんの すがたを かくそうとする。   銀・SS  すごい いきおいで じめんをほると トゲや ツメが おれてしまうが つぎのひには はえそろっている。   クリスタル  きのぼりも じょうずで からだを まるめ トゲトゲの ボールになると ずじょうから おそってくる。 	neu
 コトブキのピカチュウ『ぴーか　ぴい！』  タワーのピカチュウ『ブジューゥ!!　ブジューゥ!!』   こいつら本当に同じ生き物なの？ 	neu
 ポケスク買ったんだが、ここのスレの主要メンバーを揃えようと思っても  序盤はピカチュウとミミロルくらいしか出てこないなｗ 	neg
 エロ絵が多いポケモン   キルリア、サーナイト、グレイシア、ミミロップ  ザングース、ラティアス、ベイリーフ、ピカチュウ、ブースター、シャワーズ、サンダース、エーフィ、ブラッキー、ニューラ、マニューラ  ムウマージ、ユキメノコ、マグマラシ、バクフーン、ミュウ、ラティオス、ダークライ   もっと別なのを描いてほしい今日この頃 	neu
 >>484  きもっ 	neg
 見た目はピカチュウの方が地味だと思うけど 	neg
 明日の分を先に投下。    第2話   約十分後、僕たちはピカチュウのレベル上げを終え、トキワの森に着いた。  獏良「道具もトキワシティで充分買ったし、次の町に行っても良いよね。」  闇バクラ「そうだな、あ、そうそう。この辺からトレーナーが出始める。まあ宿主様の実力なら楽勝だろうけどよ…。」   トキワの森に入って辺りをプラプラしているとむしとり少年がこっちにやってきた。  虫取「お…、お前ポケモントレーナーだな!?俺とバトルだ！」   闇バクラ(まあこれくらいの雑魚なら楽勝だろ。オレ様が手を出す必要もねーな)  獏良「やった！勝った！」  試合は一方的だった。  既にレベルが15のピカチュウに8レベのトランセルが太刀打ちできるはずがない。  こんな調子で敵を倒し続け、遂にボクたちはニビシティへ到着した。  獏良「この町にはポケモンジムがあるんだよね！？」  闇バクラ「ん？あぁ、なんなら今すぐ挑戦するか？」  獏良「うん！もちろん！」  ボクたちはニビジムへと入っていった。  タケシ「ほう、挑戦者か…。いいだろう！試合は1対1のバトル！いいな？」  獏良「あぁ、いいよ。よぉし、いけ！ピカチュウ！」 	neu
 >>266  だったら本職を警備員に変えればいいじゃないですか   理不尽です 	neg
 >>632  >>602です。ありがとうございます！ 	pos
 ポケットモンスターダイヤモンド＆パールの「シンオウリーグ準決勝！ダークライ登場！！」の回でタクトのラティオスがサトシのピカチュウと引き分けになったな。 	pos
 レッド倒したーーー  ピカチュウLv88とか鬼畜だわ   レッド倒した時のパーティ  オーダイルLv70  ホウオウ70  ルギアLv56  残り3体は生け贄   ピカチュウ対策にホウオウにソクノの実を持たせた  ホウオウの地震で瀕死にならず倒したけれどホウオウ強い…残りのポケモン全部とどめをホウオウでさしたよ  カメックスに苦戦したなぁ。でも正直あられで助かった。あれは恵みと言いたい。  反省としてはリザードンに原始の力を使うのすっかり忘れいたことかな 	neg
 特別なこだわりがない限り最新作がオススメ  各世代間  (赤緑=第一世代、金銀=第二世代、ルビーサファイア=第三世代、ダイヤモンドパール=第四世代)  でも、  発売がもっとも最近のマイナーチェンジバージョン(赤緑でいう青やピカチュウ)がオススメ  すべてのシステムやポケモンの数などが  過去作からグレードアップするかたちをとっているから  後から出たものの方がやれることが増えてると思っていい   よって一番オススメは昨年発売の金銀リメイクのハートゴールド・ソウルシルバー(HGSS)   リメイク作品を除くなら  ダイヤモンド・パールのマイナーチェンジ版のプラチナ   GBAに拘るなら  ルビー・サファイアの(ry)エメラルド  ルビサファは中古の電池切れ高し   中古の値段はダイパよりエメの方が高いこともある 	pos
 ピカチュウがハリウッドの映画に出演とか 	pos
 >>899  これなら俺も出る 	pos
 むしろピカチュウバージョンがすげぇｗ  内容は赤緑青と殆ど変わらないのに完全新作の金銀より売れてたとか 	pos
 >>100  マニューラ  ダークライ  マルマイン 	neu
 　攻撃の手から悠々と逃げつつ、ヤミラミは問い掛ける。  「お嬢ちゃんは、このシンオウで大きくのさばっている一勢力の話を聞いたことがあるか？」  　答えを待たず、ヤミラミは続ける。  「そのトップはピカチュウで、幹部の四天王には君と同じ種族がいるそうじゃないか」   　まさしく自分のことだと、ミミロップは気付いた。荒れた息を整え、  「ええ、よく知ってる。だって、あんた達の目の前にいるんだもの。  私こそピカチュウ四天王が一匹、ミミロップ！　今更謝っても遅いけどね」  　堂々とミミロップは名乗る。自分の正体を知れば、ヤミラミ達は怯んで退くかもしれないと考えたのだ。  癪だったが、じり貧にしかならない状態から抜け出すには仕方がなかった。   「そうかそうか。やっぱりか。こりゃあ良い」  　だが、ヤミラミは怖じ気もせず、吹き出すように言った。  「えぇー、ちょ、ちょっと！　もし私に何かあったら、組織の皆がただじゃおかないんだから！」  　慌ててミミロップが言うを見て、ヤミラミ達はげらげらと笑う。  「おいおい、勘弁してくれ、今更それか。ここでお前を倒し、  ルカリオとハガネールも始末すれば、誰も俺達がやったなんて証明できやしなくなるんだぞ」  　うぐ、とミミロップは言葉を詰まらせる。苦笑いの表情に冷や汗が伝った。   「ハハッ、いやあ、まさか四天王の一匹ともあろうものがこの程度とはなあ。  他の側近、ひいてはピカチュウ自体もたかが知れるというものだ」  「なんですって？」  　ぴく、とミミロップの眉が反応する。  「トップが本当に有能なら、部下もまた有能揃いなものだと俺は思うね。その逆もまた然り。  部下が無能なら、トップの実力は推して知るべしだ。  そうだ、ハガネールとルカリオを倒して鋼鉄島を乗っ取った後は、  本土に渡ってお前達の組織を次のターゲットにしてやろう」  「……！」 	neu
 >>390  なつき度MAXで無効タイプにもダメージが与えられたり、必中技を回避したりだな  サトシのピカチュウが現実になる日は近いな 	pos
 >>560  ピポポタス回のラストの寝てるピカチュウを抱っこしてるヒカリは良かった    キャラ崩壊しないならばそれぞれのヒロインの性格ってどんな感じなんだろう?、初登場が性格のデフォと言うなら、明らかヒカリが一番いい娘なんだけどな   見ず知らずのピカチュウとトレーナーの為に、コンテストに今回出れなくても次あるからって言ってたし 	pos
 >>205  期待には応えられませんが登録をお願いしたいです  フレコ等は>>206です 	neu
 理論値的にはあと200体のヌケニンを倒せば大体50体揃うらしい　ビリジオンはもう見飽きた   捕獲出来ない個体問題はもう解決したしこのゲームで語るべきものはビビヨンとピカチュウ以外もうないんじゃないの？ 	neg
 12 名前：愛のVIP戦士＠全板人気トナメ開催中[] 投稿日：2008/06/22(日) 18:26:20.24 ID:LmVF+nqh0  ポケモンは金銀こそ至高  これ以降はゴミ   23 名前：愛のVIP戦士＠全板人気トナメ開催中[sage] 投稿日：2008/06/22(日) 18:30:15.93 ID:G3Z7600G0  >>12  同意  最近のポケモンはなんか違う・・・   73 名前：愛のVIP戦士＠全板人気トナメ開催中[sage] 投稿日：2008/06/22(日) 18:56:20.26 ID:G3Z7600G0  >>69  同意  なんであんなのなってしまったんだろうか   76 名前：愛のVIP戦士＠全板人気トナメ開催中[sage] 投稿日：2008/06/22(日) 18:56:58.69 ID:G3Z7600G0  あ、以降だから金銀含んでたのか  金銀はいいだろ金銀は   81 名前：愛のVIP戦士＠全板人気トナメ開催中[sage] 投稿日：2008/06/22(日) 18:58:56.26 ID:G3Z7600G0  金銀までしかやったことない人って結構いそうだな  金銀までしかやったことないっていう人よければ挙手してくれないか？   ノ   90 名前：愛のVIP戦士＠全板人気トナメ開催中[sage] 投稿日：2008/06/22(日) 19:01:33.30 ID:G3Z7600G0  >>87  最近のポケモンってそういうのがないんだよなぁ・・・だから駄目なんだよ  レトロ感がないっていうかさ、未完成なところがないとゲームはつまらないと思う   96 名前：愛のVIP戦士＠全板人気トナメ開催中[sage] 投稿日：2008/06/22(日) 19:04:18.48 ID:G3Z7600G0  >>94  お前金銀やったことあるの？ 	neu
 ポケスタ１とポケスタ２、両方揃えるべきか？  なみのりピカチュウ欲しけりゃ２で良かったっけ 	pos
 企画段階　　→赤緑の主人公であるレッドをモチーフにしたキャラ、サトシを主人公にする。当時人気の高かったポケモン、ピカチュウも主役に。  　　　　　　　そしてバランスを考えて原作ではジムリーダーであるキャラをレギュラーに。ヒロインのカスミや、サポート役のタケシを導入。  　　　　　　　シリーズ構成の好みに応じてロケット団のオリキャラ３人組も敵役として導入。１年物でやる予定だった。  　   無印カントー→持ち前の勢いとポケモンという題材を上手く扱った面白さで視聴者を次々とゲット。  　　　　　　　ポケモンブームに火がつき勢いは加速する。事件もあったが復帰後の人気も相変わらずで、１年物では無くなる。  　　オレンジ→タケシが海外受けが悪いという理由で降板。新たにケンジという空気系サポートキャラが投入されたがそれでも勢いの良さは続く。  　　ジョウト→これまでの視聴者を引き留めるというコンセプトなので無印初期レギュラーに戻す。だが続けていく内にポケモン自体の人気と共に勢いは低下する。  ＡＧホウエン→ここで新規視聴者を取り入れる為にカスミだけを外し、ルビサファの女主人公であるハルカやオリキャラのマサトをレギュラーに。  　　　　　　　最初は新規視聴者が結構付いたが、サトシの主役話が多く斬新な点が少なくなっていったのでそれらも離れていく。  　　バトフロ→ＡＧレギュラーを全員続投させた新作までの繋ぎのシリーズ。  　　　　　　　だがバトフロの長所を生かせない設定やレギュラーの活躍バランスの悪化などが原因で、ゲーム人気とは裏腹に人気は落ちていく…。  ＤＰシンオウ→ハルカ・マサトを外し、ヒカリを新しくレギュラーに迎える。様々な情報規制を行い、ファンの心に期待や不安の渦が巻き起こる。結局、規制はそれ程意味を持つ物では無く  　　　　　　　サトシ・タケシ（ロケット団３人組）は続投。だがこれは次回作で完全にレギュラーが一新する事を、ファンに覚悟させる計画の前準備なのかもしれない。  　　　　　　　  　　　　　　　  　　　　　　　ゲームの方はこれまでの集大成となり、次回作では完全に一新されるので、アニメもそのコンセプトで行く可能性大。 	neu
 わかったよ  とりあえずピカチュウくれ 	pos
 ピカチュウ  ピチューが進化して電気をコントロール出来るようになった出来るようになった  哺乳類型ポケモンだ。通称・電気ネズミ  可愛い顔に騙されると痛い目にあうぞ。  必殺技は強力な電撃を落とす『１０万ボルト』と電気の衣を身にまとい  そのまま体当たりする『ボルテッカー』 	pos
 ピカチュウ預ける積もりないのか 	neu
 >>711  わからん 	neu
 言っちゃ悪いがそのせいで>>614の前半と後半矛盾してないかｗ  電撃波覚えるのに電気技吐くの怖いんじゃないかって 	neg
 >>898  交換ありがとうございます  アメ無かったのでポイントアップで許してくだされ 	pos
 ようつべでサトシとヒカリが手を  つないでいるとこがあった。  後、ポカブとミジュマルと  ツタージャとサトシの  ピカチュウとヒカリの  ポッチャマもいた。   これはやはり嘘なのか………。 	pos
 かそくブースター◆2E1g97cXqQ  ピカチュウ◆uprYj.hack  休カ無限◆979cBHtDdc  ポケモン板を代表する糞厨房コテ一覧  共通点：構って欲しさにスレをageまくる  やけに自信過剰  明らかな厨房レス   鳳凰＠海流＆原画■■ ◆HOUOUp2H5w   コイツを超える真性の糞コテはありえない 	neg
 >>314  すみません。遅くなってしまいましたが登録させていただきました。 	neu
 >>287  >>293  どろかけ 	neg
 ポケモソいえるかなか･･･  消防の頃に  ピカチュウ　怪獣　焼肉定食　ピジョンの丸焼き　つぶやきシロー･･･  とかやったなぁ、  	neu
 ピカチュウ主人公の要素全く無いくせに  主人公のパートナーをやってる 	neg
 >>368  全身余すとこなくコピーして学習しないとな！   …粘液ぷれい？ 	neu
 >>337  ボールを投げたときのピカチュウの動作が少し可愛いからいいんじゃないか？ 	pos
 マグマラシとそれなりに気が合うというオーキド研究所の裏設定みたいな感じで。  んでバクフーンに進化してたりして。バクフーンといえばライコウ雷伝説。  あの話自体が伝説と化した。ワタルとヒロイン。  メガニウムを使うギャグ担当のライバルが本編に登場してフシギダネに倒された。  フッシーダネダネとゼニガメガの声は忘れない。かなりの仲良し描写だった。  フシギダネとゼニガメがミュウツーの逆襲の空を飛んでいるポスターを思い出す。  ミュウツーとミュウと言えばオープニング。  心に残すべきミュウツーとミュウの画だ。  雷伝説の視聴率がもし良い結果だったらサトシが降りていたとかいないとか。サトシのサバイバル。  恋愛事情みたいなものはピカチュウとミミロルが適度だったね。  ナエトル。だから進化させないでと。  挫折と成長がコンセプトだから、ハヤシガメに進化して挫折して成長してってわけか。  普通にフシギダネればよかったのに。  ガブリアス♂。シロナ女神と女将ガブリアス♀の雄々しさと凛々しさにチョッカイをかけることになっちゃう。  フカマルは今のフカマルでよかった。  ヨーギラスのようないわゆる感動巨編は無くてもフカマルはこれがいい。  あの赤毛兄ちゃんとヤジロンの回でフカマルから健気さを感じた。  ようするに「ユクシーの影！」から考えて仲は普通に良いようだ。  コンテストの方が和気あいあいとしてたよね。  ヒカリ・ノゾミ・ケンゴ・ナオシ・ウララ。  ヒカリとノゾミが二人で「主役はポケモン」とハモってコンテストの主役はヒカリとノゾミだよ、と伝えた演出。  ヒカリがハニカんでいたね。  ヒカリとノゾミについては、演出の通り。  ウララとノゾミの一瞬の会話も、ウララの気丈さとノゾミのボーイッシュさがあった。  ガバイトって、もしかしてガブリアスとフカマルのいいとこ取りした風貌なんじゃないのかと気が付いた。  ウララとガバイトは相性がよかった。 	neu
 きいろのもりで秘伝ピカチュウ探してるのだが  昨日夕方送ったイーブイで、貯めてもせいぜい200ｗちょっとでポケトレやり始めてて！しかでなかったんだけど  扇風機にくくりつけて一気に600ｗほど貯めてポケトレやったら2回に一回くらいは！！が出るようになった。  明らかに！！が出やすくなったんだけどｗ(もしくは歩数)貯めるのはやっぱり効果あるのかな    もともと！一回、！→！で出てくる2種類は確定してたから！！でも期待してなかったけど4匹捕まえて  3匹戻したら案の定3匹ともLv13のじたばた持ちだったが・・・  イーブイ戻してゴルダックつれてったけど、一回の散歩ででてくるポケモンは3種固定でいいんだよね？ 	pos
 ピカチュウ 	neu
 ピカ様一匹も倒せて無いですピカ様 	pos
 >>456  それもスレ違い 	neu
 >>456  だめだ　……　おれには  かいどく　できない！ 	neg
 マリオ枠が5になったからポケモンも5だろ   ピカチュウ ミュウツー ルカリオ 新ポケトレ ゲノセクト   完璧だな 	neu
 来年の劇場版の名称は『ピカチュウ決死隊』 	neu
 >>122  あー！なるほど！  さんくす！   ちなみに俺は・・・向こうは任せたにして暴れさせてるぜ！  Ｌｖ上げ目的だけであって、箱落としても拾ってくれないんだよね・・・ 	neu
 7月1日発売   ピカチュウのミニ蒸しケーキチョコ  （173kcal/1個　関東 東北 関西）  実勢￥84前後   どうやらこれまで発売していたプラスルの次商品らしい   ポケモンシュガーバターロール  （245kcal/1個　関東 東北 関西）  実勢￥105前後   早くもミミロップ終了のお知らせ！？ 	neu
 >>204  メジャーどころだとガラ☆、ライパル、サンダーネール厳しいかな。ナッシーも怖い。  それとこれじゃあ身代わり☆一匹で全滅だ。   ピカチュウだから仕方ないとはいえカビパルゲンの間接に頼りっきりな感じがする。  麻痺直しめざ飛こらきしあるいは爪寝言ヘラと、毒あまブラ欲しいかな。そのメンツだとムドー呼びにくいと思う。ガラガラはいらない。  ギャラでんじほうカビのしみたいだが特殊エースに麻痺の恩恵は少ない。カビゴンののしかかり→文字かあるいは鈍い寝言もおすすめしておく。  とりあえず取り巻きの物理にピカチュウ以外のもう一つ決定力が欲しい。あと毒。   かなり適当だけど思ったことはこれくらい 	neg
 ピカチュウ 	neu
 >>439  つ[AM3] 	neu
 >>469　それがいいと思う。ただ、アルセ戦のときは  ドン達など他のポケモン達も味方していたので  俺的にはドン達が周りの雑魚をやっつけている間に  ピカチュウ一行（いつもの四匹）vsダークライの戦いが繰り広げられる  というのがいい。   まあ、こういったことは書く人が決めるのが一番だと思うけど・・・ 	pos
 >>384  愛誤発見！  萌えスレでマランネと遊んでなぁ！ 	neu
 >>609みたいなキモいサトシ腐女子  文体でバレバレ 	neg
 861 ：名無しさん、君に決めた！：2009/06/21(日) 23:26:34 ID:???  801 ：名無しさん、君に決めた！：2009/06/08(月) 18:31:09 ID:???  無印２話を見返したらもっと酷いことに気が付いた  カスミに避けられ落ち込んでいたキャタピーの目の前でピカチュウを抱き上げ「気に入られるならキャタピーよりピカチュウの方がいいもーん（笑）」  それを見て更に凹んで涙目になったキャタピーを「こいつ」呼ばわり＆「早くモンスターボールに戻せ」   809 ：名無しさん、君に決めた！：2009/06/08(月) 18:43:00 ID:???  >>801  追加  朝起きてキャタピーが側で寝ていたのに対しキャタピーの前で「今日まで１０年間生きてきて最低最悪の朝だわ」  キャタピーの顔を睨んで「ポケモンならポケモンらしくモンスターボールに入ってなさいよ！！」と怒鳴る  「サトシがキャタピーをゲットできたのは相手がたまたまトロかったから」とキャタピーの事を悪く言い、サトシもそれに反感   880 ：名無しさん、君に決めた！：2009/06/21(日) 23:30:08 ID:???  >>861  ＞キャタピーの目の前でピカチュウを抱き上げ   しかもこのときピカチュウは落ち込んだキャタピーを励ましてる最中だったからな  それを遮断してまでキャタピーを貶し始めるとかどんだけ性格悪いんだ 	neg
 メトロイドプライム：ハンターズ  ttp://c.streamingmovies.ign.com/pocket/article/513/513153/metroid_051304_01_wmvlow.wmv  マリオ64x4  http://c.streamingmovies.ign.com/pocket/article/513/513155/mario64_051304_01_wmvlow.wmv  メイドインワリオDS  ttp://c.streamingmovies.ign.com/pocket/article/513/513157/warioware_051304_01_wmvlow.wmv  pac-pix  ttp://c.streamingmovies.ign.com/pocket/article/513/513158/pacpix_051304_01_wmvlow.wmv  半熟英雄  ttp://c.streamingmovies.ign.com/pocket/article/513/513162/egg_051304_01_wmvlow.wmv  バルーントリップ  ttp://c.streamingmovies.ign.com/pocket/article/513/513163/balloontrip_051304_01_wmvlow.wmv  ホッケー  ttp://c.streamingmovies.ign.com/pocket/article/513/513164/tablehockey_051304_01_wmvlow.wmv  DSピカチュウ  ttp://c.streamingmovies.ign.com/pocket/article/513/513165/pikachu_051304_01_wmvlow.wmv  潜水艦  ttp://c.streamingmovies.ign.com/pocket/article/513/513166/submarine_051304_01_wmvlow.wmv  エフェクトデモ  ttp://c.streamingmovies.ign.com/pocket/article/513/513167/specialeffects_051304_01_wmvlow.wmv  ソニック  ttp://c.streamingmovies.ign.com/pocket/article/513/513168/sonicdemo_051304_01_wmvlow.wmv  カービング（彫刻）  ttp://c.streamingmovies.ign.com/pocket/article/513/513321/carving_051304_01_wmvlow.wmv 	neu
 残念ながら今回もグローバルアトラクション「ピカチュウ1億匹ゲット」は失敗に終わったためバシャーモナイトが今後手に入ることはありません 	neg
 >>141  でたら、それ買うぞ！！Z指定でもな！！ 	pos
 ピカチュウ 	neu
 ……  バクラに敗北したあと、遊戯は橋の上で佇んでいた。  「……ッフ、やってやるぜバクラ！！」  遊戯の誓いの叫びがゴールデンブリッジ中に響いた。……   ……さてと、ポケモンセンターにも行ったことだしさっさとハナダジム戦を終わ  らせるか……。  ハナダジムに入るとジムリーダーのカスミが待ち構えていた。  「来たわね！噂には聞いているわ。ゴールデンブリッジのトレーナー達を倒した  んですって！？この辺だと有名よ。」  ほう、オレ様はかなりの有名人になったのか。望ましいねぇ。  ただ、オレ様はいずれビッグになる。こんな田舎で有名人になったところで意味  ないのよ。  オレ様は適当に聞き流し、バトル開始を宣言した。  バトル開始と共に出てくるのはピカチュウ。  対するカスミはヒトデマンを繰り出す。ククク、水ポケなんざオレ様のピカチュ  ウで一撃よ！  「先手必勝だぜ！ピカチュウ！10万ボルトだ！」  遊戯戦でレベルの上がったピカチュウは既に10万ボルトを修得していた。 	neu
 ピカチュウ 	neu
 >>971  俺もヨーロッパ版2DS持ってるけど  国内シリアルは全部不可、wifiや赤外線はOKだった  ドイツで配布されたディアンシーのコードは通ったけど  ポケモンスクラッチのコードは一切通らなかった 	neu
 あ      現人神・サトシのリザードン　「　無印が思い出補正かどうか検証してやる。　」   女神ヒカリのポッチャマ皇帝　「　DPと無印の比較をしよう。　」      無印　→　無印ピカチュウ。　ヒトカゲ。　フシギダネ。　ゼニガメ。　カイリュー。　ミュウツー。   ＤＰ　→　ＤＰピカチュウ。　ヒコザル。　ナエトル。　ポッチャマ。　ガブリアス。　アルセウス。      現人神・サトシのリザードン　「　無印は原点にして頂点。　」      あ 	neu
 >>830  ヒロインとの関係は確かに改善されたと思う  まるっきり別々にやられるより一緒になってたほうが  団結力があって見てて面白いと思う 	pos
 >>306だけど2000歩くらいでついてきたあ！  ありがとよー 	pos
 全国図鑑No.288　ホウエン図鑑No.037　シンオウ図鑑No.-　分類：あばれザルポケモン　タイプ：ノーマル  タマゴグループ：陸上　特性：やるき　夢特性：-　高さ:1.4m 重さ：46.5kg  HP：80　攻撃：80　防御：80　特攻：55　特防：55 素早さ：90   ナマケロ時代に貯めていたエネルギーがここにきて爆発したあばれザルポケモン。  いつも暴れたくてウズウズしており、1分でも座っていることが出来ない。  動いてばかりいるのですぐに空腹になってしまうが、食事のときもジッとしていられない。  止まっているとストレスが溜まってしまうクレイジーなポケモンである。  猿に進化したので、モチーフがナマケモノなのか猿なのかよく分からないことになっている。  もしかしたら某ぶたざるのようにナマケモノ＋猿なのかもしれない。   ケッキングとは違った特性や高めの素早さを持ち、対人戦で起用されることもある。  特に第四世代初期は催眠技が猛威を振るっていたため、特性が有利に働くことが多かった。  BWでは進化前のポケモンの防御特防が1.5倍になる"しんかのきせき"が登場。  当然ヤルキモノもこの道具の恩恵を受けることになり、無振りでも物理耐久が非常に高くなる。   アニメではセンリの手持ちとして登場。ホウエン地方を旅立ったばかりのサトシのピカチュウに勝利した。  その後の再戦でもコータスを一撃で倒すなど、その強さは健在だった。  AG88話ではサトシたちの特訓でナマケロから進化したヤルキモノが登場。バナナナマケロ園を食い荒らすカビゴンに立ち向かい撃退に成功した。 	neu
 電撃ピカチュウは残して他は狩るってことで? 	neu
 「あのピカチュウ使いの少年、昔のお前にそっくりだな」とか言いそう＞マスター 	neu
 >>30  じゃぁドラえもん見て竹とんぼドタマにくっつけてマンションから  飛びおりて死んだ消防がいた、とかなるとドラえもんは洗脳？  現実的な話２ｃｈの方が洗脳くせーけどナー。(ｗ 	neg
 何を言うピカチュウよ  その相容れないのを強引に結び付けるのが愛じゃないか 	pos
 ピカチュウと結婚するにはどうしたらいいですか？ 	pos
 ピカチュウ 	neu
 ギザミミゴーリキー ♀  プレシャスボールに入っている  クラシックリボンを持っている  かわらずの石を持っている  覚えている技  空手チョップ、気合いだめ、痛み分け、インファイト    ピカチュウカラーのゴーリキー ♂  プレシャスボールに入っている  クラシックリボンを持っている  かわらずの石を持っている  覚えている技  空手チョップ、気合いだめ、ボルテッカー、インファイト 	neu
 赤・緑・FR・X  つぼみが せなかに ついていて ようぶんを きゅうしゅうしていくと おおきな はなが さくという。  (漢字) つぼみが 背中に ついていて 養分を 吸収していくと 大きな 花が 咲くという。   青・LG  せなかの つぼみが おおきく そだってくると 2ほんあしで たつことが できなくなるらしい。   ピカチュウ・ポケモンピンボール  ようぶんを とって おおきくなった つぼみから かおりが ただよいだすと もうすぐ ハナがひらく しょうこだ。   金・HG  たいようの ひかりを あびるほど からだに ちからが わいて せなかの つぼみが そだっていく。   銀・SS  せなかの つぼみから あまいかおりが ただよいはじめたのは もうすぐ おおきなハナが ひらく しょうこだ。   クリスタル  せなかの つぼみは ようぶんを きゅうしゅう して ふくらむ。はなのさくころ いいにおいが する。   R・S・E・OR・AS  つぼみを ささえるため あしこしが つよくなる。ひなたで じっとする じかんが ながくなれば いよいよ たいりんの はなが さくころだ。  (漢字) つぼみを 支えるため 足腰が 強くなる。日なたで じっとする 時間が 長くなれば いよいよ 大輪の 花が 咲くころだ。   D・P・Pt・B・W・B2・W2・Y  せなかの つぼみが ふくらみだすと あまい においが ただよいはじめる。たいりんの はなが さく まえぶれ。  (漢字) 背中の つぼみが ふくらみ出すと 甘い においが 漂いはじめる。大輪の 花が 咲く 前触れ。 	neu
 エレキングにハムスターでピカチュウさま。 	pos
 いいね。ピカチュウが過去にタイムスリップして  影で助けるとか？ 	pos
 >>237  ダーテングとルンパッパ、どうして差が付いた 	neu
 ピカチュウさんが一番かわいいのだから優遇されて当然じゃなくって？ 	pos
 >>48  大谷はおそらくピカチュウが一番知名度ある持ちキャラなんだからそらそうでしょ 	pos
 ガネシオンダンジョンに出現  ゴース（まれに）  ゴースト（ふつう）  ゲンガー（よくでる）  ピチュー（よくでる）  ピカチュウ（ふつう）  ライチュウ（まれに 	neu
 ガラガラとピカチュウはいれんなよ 	neg
 やっぱサトシのピカチュウだろWW 	pos
 さ・・・さすが帝王になるオトコ・・・いやオス・・・。  ちからもちぃ！！  てか、ミロカロスとキュウコンとボーマンダの正体知ってるのってピカチュウだけでしたっけ・・・  もっといるのかと思ってた 	pos
 サンダー＠メガネ  ピカチュウ＠電気玉  ライチュウ＠襷  サンダース＠風船  エレブー＠奇跡  レアコイル＠スカーフ  遊びで参加するのもありだよね 	pos
 >>547  フレコ間違ってます。 	neg
 3月にピカチュウ配りそう   でもピカチュウよりボルテッカーを電気タイプに配ってもろて	pos
 とりあえず馬鹿な事を考えた。  電気玉ピカチュウは知ってると思うがカイオーガを  倒す力を持っている。  ただカイオーガだけじゃだめなので更に  めざぱ草を覚えさせてラグラージ対策。  それか、電気が効かない香具師に対抗しやすい  めざぱ氷。  どうよ？・・・って夢のまた夢か。 	pos
 >>997  ありがとうございます！  オンラインになっていますので申し込みの方お願いします  ＴＮア○○○トです 	pos
 >>86  ちょっと冷静になれお前  ピカチュウが神は言い過ぎだろうが、ゴミは… 	pos
 >>456   言っても４年後の話だがな 	neu
 >>895  ゲンガーは、  「あっちに行けばキミのお兄ちゃんピカチュウにあえるぞ」  と言って、閉じ込めている。なぜ閉じ込めたかときかれると、やはり足手纏いになるからだろう。ちゃんと救助にも行っている。 	neg
 >>793-794  ショーボート回じゃ可愛く活躍してたし  サトシvsピカチュウの回の後半であんなにカッコ良く活躍していたのに…＞ライチュウ  知ったか厨乙。それとも釣りか？ 	pos
 適当にまとめた版  フシギダネ：ナエトル　　フシギソウ：ハヤシガメ　フシギバナ：ドダイトス  ヒトカゲ：ヒノアラシ　　リザード： マグマラシ　 リザードン：バクフーン  ゼニガメ：ワニノコ　　　カメール：アリゲイツ　　カメックス：オーダイル  キャタピー：ビードル 　 トランセル：コクーン　　バタフリー：スピアー  ポッポ：ムックル　　　　ピジョン：ムクバード 　 ピジョット：ムクホーク  コラッタ：ビッパ　　　　ラッタ：ビーダル  オニスズメ：スバメ　　　オニドリル： オオスバメ  アーボ：ドガース 　　　 アーボック：マタドガス  ピチュー：トゲピー　　　ピカチュウ：トゲチック　ライチュウ：トゲキッス  サンド：フォレトス　　　サンドパン：クヌギダマ  ニドラン♀：ニドラン♂　ニドリーナ：ニドリーノ　ニドクイン：ニドキング  ピィ：ププリン　　　　　ピッピ：プリン　　　　　ピクシー：プクリン  ロコン：ガーディ　　　　キュウコン：ウインディ  ズバット：グライガー　　ゴルバット：グライオン　クロバット：プテラ  ナゾノクサ：マダツボミ　クサイハナ：ウツドン　　ラフレシア：キレイハナ　ウツボット：マスキッパ  パラス：キノココ　　　　パラセクト：キノガッサ  コンパン：ケムッソ　　　モルフォン：ドクケイル  ディグダ：ドードー　　　ダグトリオ：ドードリオ  ニャース：エネコ　　　　ペルシアン：エネコロロ  コダック：メノクラゲ　　ゴルダック：ドククラゲ  マンキー：エイパム　　　オコリザル：エテボース  ニョロモ：ラルトス　　　ニョロゾ：キルリア　　　ニョロボン：エルレイド　ニョロトノ：サーナイト  ケーシィ：ゴース　　　　ユンゲラー：ゴースト　　フーディン：ゲンガー  ワンリキー：イシツブテ　ゴーリキー：ゴローン　　カイリキー：ゴローニャ  ポニータ：デルビル　　　ギャロップ：ヘルガー 	neu
 ピカチュウ 	neu
 ピカチュウやポッチャマよりコイルの方が人気だよ 	pos
 >>668  レベルを上げてない  なつき度とポケパルレを勘違いしてる  そもそもなつき度が足りない   このどれか 	neu
 >>430  カナーリ懐かしいねw  ってかあの頃の絵見てると恥ずかしい限りだ(´・ω・`)   >>471  Ｇ・・・ＧＪ!! 	neu
 >>831  まぁそうなるわな。  デオキシスがボールだったし４枠ならプリンもひょっとしたら出れるかもしれない、って感じか。   でもぶっちゃけポケモン３枠でいいよな・・・。  プリン出すくらいなら、デデデとかディディーディクシーとかキングクルールとかクッパＪｒとか、  色々優先すべきキャラがいると思う。  プリンが出場したせいでこれらのどれかが出なかったらプリン叩きはじまりそうだな 	neg
 アニメ版のサトシはいつピカチュウをライチュウにする気だ？  ライチュウの方がカッコいいのにな 	neg
 くさむすびピカチュウとプレゼントピカチュウと一緒に  四天王勝ち抜けるピカチュウＰＴは？  	neu
 >>712  きてないけど   >>713  なにが？ 	neu
 俺の彼女（小野寺結衣）のまとめ  日テレで朝放送中の情報番組ZIP！の  月曜と水曜、金曜日の放送に出演  今日予報担当  現役女子大生  ポケモンファン （ピカチュウやチラーミィ等のかわいい系がすき）  生年月日：1991年8月31日  身長：156cm  血液型：Ｏ型  出身地：アメリカ(シカゴ)  学歴：慶應義塾大学総合政策学部在学中  趣味：グリーティングカード作り、お買物、ネイルアート、アロマ  資格：英検2級、AFS54期生 	pos
 　こくり、とアブソルが頷く。  「お願い、ギラティナさん。消えるなんて言わないで。パルキアさんも、どうか許してあげて」  　ふ、とギラティナは全身の力が抜けたように息をつく。それを見て、少し口惜しげにパルキアも爪を退いた。  「アルセウス……果ての果てまで意が読めぬ、どこまでも身勝手な奴よ。  ほとほと心の底から愛想が枯れ尽きたわ。そんな奴に与えられた役目になど縋っていたのがとても馬鹿馬鹿しくなった。  もう勝手にするがいい。私は私で現世を好きに生きさせてもらう……それでよいのだな？」  「うん……さすが、素直じゃないとこがよく似てるみたい」  　くすくすと笑うアブソルに、ギラティナは鼻を鳴らして顔を背けた。  　こうして、壮大な神々の家族喧嘩に一応の決着がついた。後は無事に帰るだけ――  「さて、後はピカチュウ。禁忌を犯した者への処遇についてですが」  　――とは、いかないかもしれない。   	neu
 レッドはヒトカゲと　ピカチュウと　コラッタと　バタフリーをくりだした！ 	neu
 >>595  動きが鈍すぎ 	neg
 >>512  ありがとうございます  ぜひ交換お願いします  対応は>>511さんのあとの時間になりますがよろしいでしょうか？   >>513  すみません、先に３種申し出てくれた方がいるので３種については>>512さんを優先します  残りのルアーピカチュウ(ピチューのままでも可)をお願い出来るならお願いしたいのですがダメですか 	neu
 >>101さとしのばかーん 	neg
 プラマイパチリスみたいなピカチュウポケモンはまた出るだろうか 	neu
 ★努力値稼ぎ   努力値はフル状態で510まで振れる。ただし１つのステには255までしか振れない。  （努力値は4の倍数で計算されるので　255まで振らないで252で止めるのが吉。）  大抵は適当なステを2極であげたほうがいい。ステ２つを252まで上げると、最後に6余るので、適当なステに振る。  薬で努力値を各ステ分100上げれるので2極の場合は適当な薬2種を10ｺずつ買って使えばいい。  （薬1個で貰える努力値は10。薬で上げられる努力値は100まで）  薬2個を10ｺずつ使ったあとは、各ステの努力値が入る敵を152匹狩ればいい。（ちなみに強制ギブスがあるなら76匹でいい）   HP+1：ベトベター（ポケモン屋敷）  攻撃+1：ワンリキー（イワヤマトンネル）マンキー（22番道路）パラス（お月見山Ｂ１）  防御+1：イシツブテ・イワーク（イワヤマトンネル）  特攻+1：ゴース（ポケモンタワー）  特防+1：メノクラゲ（海）  素早+1：ディグダ（ディグダの*）スバット（洞窟）ポッポ・コラッタ（その辺）   HP+2：マリル　ヌオー　ソーナンス　ランターン  攻撃+2：オコリザル　ゴーリキー　ドードリオ　キングラー　アズマオウ　ギャラドス　アーボック　サイドン　アリアドス  防御+2：コクーン　トランセル　ゴローン　サンドパン　ガラガラ　ヤドラン　マタドガス  特攻+2：クサイハナ　ゴルダック　レアコイル　ゴースト　ブーバー  特防+2：ドククラゲ　スリーパー　ジュゴン　レディアン  素早+2：ラッタ　ピジョン　オニドリル　ゴルバット　ダグトリオ　ピカチュウ　ペルシアン　ギャロップ　マルマイン　オオタチ 	neu
 >>57  >>58  お前ら… 	neu
 ストライクのままで使うとかキチガイだろ  お前はピカチュウが本当に強いと思ってるのか?  	neg
 今ピカチュウ出たって言うから焦ったじゃないか・・・  ぐぐれば出るんじゃね？  てか１つにつき１００メガってwww 	neu
 オオスバメの背中に乗るヘイガニは萌える  でも水ポケはブイゼルが一番強くなりそう   リザードン オオスバメ ジュカイン ピカチュウ ブイゼル ドンファンでリーグ制覇して欲しい  最後はレギュラーで旅してきたメンツでってことで 	pos
 1996　赤・緑・青  1997　  1998　ピカチュウ  1999　金・銀  2000　クリスタル  2001  2002　ルビー・サファイア  2003  2004　ファイアレッド・リーフグリーン・エメラルド  2005  2006　ダイヤモンド・パール 	neu
 おやすみピカチュウ使ってる人けっこう少ないんだな 	neg
 >>240  ん？どうした？ 	neu
 >>439  たたきつけるとかあるから  普通よりは強いよ 	pos
 >>8  あんまり可愛くないよなあれ  かピカチュウは一番ピカ版のグラフィックがいいなぁ 	neg
 >>594  >>595   すげえ分かるその気持ち  でも、自分はサトシが好きだから一応見てる。  ヒカリを見るとむかつくよな・・・  あと、最近ポッチャマをピカチュウと同じように外に出してるのがすげえ嫌。  何目立とうとしてんだよみたいな。うざい。  どっちも消えればいいのに 	neg
 >>578  >>584  無理に解釈してみた   メアリは本とかでピカチュウ知ってた  フーパが出したのは金銀財宝は悪徳業者とかから、種は村の倉庫みたいなとこから持ってきただけ、  ブロックも別の場所で作ったものを運んだだけ、ドーナツはドーナツ屋とかがフーパに取られる事を公認している  黒レックには内心みんな驚いてる  ゲングラが凍ったのは一時的に冷ビのダメージ受けていただけで所謂氷状態になった訳じゃない   こんな感じでどう? 	neg
 >>217  自慢の庭 	pos
 ピカチュウはボルテッカー持ちで 	neu
 >>64  ヒカ厨やサトヒカ厨はサトシ降板前提で話す奴多いんだよな  ヒカリだけ降板嫌だからって別格のサトシ巻き込むのが嫌な感じ 	neg
 参加者の関係：友人関係は有りだが、最初から恋愛は無し、途中からも余りやらない方が無難。  プロローグ大筋：プロローグの続きとして説明をするSSを追加した方が良さそう。  通信進化：託すトレーナーとポケモンの絆＋託されるトレーナーとポケモンの絆＋トレーナー同士の絆で良いと思う。  サカキのルール説明：>>606の、禁止エリアの猶予＋支給ポケモン～奪い合い＋ライフライン＋ポケモンだけで遠くに行けないで良いと思う。  　　　　　　　　　　ジョーカーは、ロケット団員が混ざってるよ的な発言で面白くなりそう。服装も>>613>>616にあるような感じで。  ロワ中の技取得：技マシンはタマムシのが有りで良いと思う。あとはレベルと関係無いとでもして覚えるのを有りにするかどうか。 	pos
 ピカ版のリメイクなんてもう一生無くていいだろｗ  変更点なんてもう主人公の後ろにピカチュウを連れていけるだけだし  同じカントー地方でシナリオも赤緑版と何ら変わりはない ダイパから連れ歩き搭載の時点で需要は100％なくなった 	neg
 ピカチュウ「げんきでちゅう」 	pos
 ピカチュウのごり押しうぜー 	neg
 最近ピカチュウになった 	neu
 最近のアニメじゃピカチュウは  普段の回じゃ目立ってない上にリーグ本戦では一回も勝ててないけどな   弱杉 	neg
 >>660  4382-1950-3548  マンキー、ナゲキ、キノガッサです。よろしくお願いします。 	neu
 ライチュウ派ってやっぱ少ないんだな…    アニメではサトシが  「俺のピカチュウもいつかは進化する時がくるかもしれない」とか言ってたけど  ポケスペのレッドもいつかは進化させるんかな 	neg
 ずっと気になってるんだが、ウツギ博士はピカチュウが進化したポケモンということを発見したのに、  卵のことは知らなかったんだよな（ピチュ－は卵からしか生まれない）。これってどういうことだ？ 	neu
 育てる気も、図鑑を完成させる気もなくても   トキワの森でピカチュウ  お月見山付近の草むらでプリン  お月見山でピッピ  ハナダでケーシィ   は必ず捕獲 	neu
 >>68  いや、かわいいけど 	pos
 >>93  おお！よかったな！  スカパー！羨ましす…  連携プレーが美味しいよね、ウパー会。ピカチュウもなかなか可愛い覚えがある   実は金銀の頃受験だったから見てなくて、他のオススメが思い出せん…  またあったらここに書いとくよ  もし良い話あったら是非情報を！ 	pos
 >>419  自然といいつつ全部♂な罠   でも(ﾟ∀ﾟ)ｲｲ!! 	neu
 >>836俺は   アルフの遺跡と繋がりの洞窟のどちらかをアジトにするか4匹で議論  ↓  観光地になっているアルフは適さないと結論し、繋がりの洞窟へ行く  ↓  繋がりの洞窟も人間だらけだったのでヤドンの井戸へ変更  ↓  前座としてズバットの大群を撃破  ボスのヤドキングを倒して拠点に   ってな感じで進めてた。 	neu
 プラマイやパチリスは黒歴史  あんな二番煎じの糞キャラのせいでピカチュウの個性が薄らいでしまったorz 	neg
 ポケモンのゴミはピカチュウだけだろ   ピカチュウ死ね 	neg
 ファイアロー  ピカチュウ  ニャオニクス♂  ヒトデマン  トリミアン  ルカリオ   ルカリオは穴埋め要員だったのに凄い活躍してくれたわ  トリミアンも耐久あるし、おんがえしゴリ押しも役に立った 	pos
 なるほど、ピカチュウvsイーブイという再戦フラグ立ててたのに何で戦わないんだと思ってたけど、  そういう風に考えると納得。試合前にサトシもシゲルのデータ閲覧してたしな 	pos
 画質悪い上に重くてごめん。  http://0bbs.jp/pocket/img0_3  ピカチュウ  http://0bbs.jp/pocket/img0_4  カイリュー  http://0bbs.jp/pocket/img0_5  ランターン 	neg
 昨日ﾋﾟｶﾁｭｳの巨大クラフト持って帰り道歩いてたら  消防に「あっピカチュウだ」って言われた 	neu
 >>700 この件をポケモンのサポセンに問い合わせてみたら交換はamazonの方でやってくれと言われた… 	neu
 ピカチュウが看板キャラになってからポケモンは腐ってきた 	neg
 なにより  サトシパーティにエスパーがいないからブラッキーを入れるのは  リスクでしかないんだよな。   パートナーは実際カメックスだったわけだが。  カメックスを地面２体、炎２体で完全にカバーする形になってるのもいいと思った。  ゴローニャと炎２体はリザードンにも強いし。  （結果としてゴローニャダメダメだったけどw）   サトシは地面がくると読んでピカチュウを外し  ベイリーフ、冷凍パンチの使えるカビゴン  ブラッキー読みのヘラクロス、かなり高度なメンバー選定だったと思う。    ハヅキ戦はしらん 	neg
 >>188  電力はワット  ポケピカやり直しなさい  うんこ 	neu
    　　　　　　　見て無い人も居るかも知れませんが   　　　　　　　次の安価は５００です   　　　　　　　　　　　　　　　>>430       	neu
 サトシに尽くしていいのは自分だけでサトシの愛情を受けていいのも自分だけ  サトシにいっぱい尽くしたいけど結局うまくアピール出来なくて空回り  サトシはいつまでたってもピカチュウピカチュウ…  溜まったストレスはエッチな妄想で発散  妄想の中ではサトシに尽くしまくり、見返りにサトシから愛情をたっぷり注いでもらう（妄想です）  サトシが絡まなければ普段はいい子 	pos
 求）HABDSようき夢トルネロス  出）10ANNIV（ホウオウ、ピカチュウ、フリーザー、ラティアス、ルギア、リザードン、エンテイ）  10 ANIV(エーフィ、バクフーン、スイクン、カメックス、カイリュー、ラティオス) 	neu
 　　 　(＼　(＼  　　　/　 _⌒ ._ヽ  ／ヽ| 　.´・ .〈・ |　　　ピカチュウもわしが育てた  ヽ　 | 　　 r､_）　）　　　　だからタイガースの優勝は目に見えてるんや  　 .>| 　　`ﾆﾆ'　ヽつ  　 ヽ|　|_/　　　　│ 	neu
 ピカチュウ：ゲームしない人でも知ってる。  ミュウツー：ポケモンやってなくてもゲームする人なら大抵知ってる。  セレビィ：ポケモンやってなきゃ「何それ？」って感じ。   ピカチュウ＞ミュウツー＞＞＞＞＞＞＞＞＞＞＞＞＞＞＞＞＞セレビィ 	pos
 >>19  最強じゃん 	pos
 >>912  実際自分のポケモンよりヒカリ心配したりピカチュウ置いてくのも気にせずヒカリーって言ってたしな 	neg
 気むずかしそうなポケモンのピカチュウに草 	neu
 どれのこと言ってるのか判らないけど技術がないと愛を形にするのは難しい。  たぶん俺がピカチュウ描いたとしても>>654のように思われるだろうな。 	neu
 >>602  どこをどうみたら自演に見えるんだよ 	neu
 >>140  サトシじゃなくポケモン同士ならOK  ナレーションはしょこたんで 	pos
 最近ピカチュウのエロ絵が少なくて困る 	neg
 今朝ピカチュウになった夢を見た  体には特に違和感は無し｡歩きたいと思えば前に歩けた｡  周りは草原みたいな所で先に進むといつの間にか薄暗い森の中に入ってた｡  適当にうろうろしてたら武装した鎧を着た男が突然出て来て自分は驚いてたら､周りが急に白く光って気づいたら男に捕まってた  自分は背中を掴まれてて男はどこかに向かって歩いてた｡怖くて目を瞑ってたらいつの間にか目が覚めてた   嬉しいような嬉しくないような微妙な夢…(´･ω･) 	neu
 別にほしくなかったけどピカチュウでやってみたら40いったんだけど、出ないねぇ  これ結構時間かかるよねぇ・・・眠れないじゃないか・・・ 	neg
 33回やったけどXmasピカチュウ出ない  それ以外はゲットだぜ 	neg
 >>621  ・・・なーむーだな   >>624  デデデデ・・・?  …ああ、ペンギンか。　ハブネークの方が先じゃねーの?   >>625  まあ鋼タイプだからなー  全身堅いぜー、特殊攻撃には弱いけどなー   >>626  明日…アス……ああ・・・  エーフィって時々すんげえこと言うよな・・・・   >>627  知り合いの人間が失敗して。ソースがプリンみたいになったって言ってたぜ  なんか嫌だなー、それも   キノコかー、パラセクトとかキノガッサはうめーのかな?  	neu
 >>26  スペースでも入ってたんじゃない？ 	neu
 スタッフがサーナイトを黒歴史にしようとしてるんだよ  ピカチュウなんかよりも人気はあるんだけどな・・  萌えスレのピカチュウなんてまだ2スレ目だし  クチートとかに比べると差は歴然 	neg
 >>507  【フレコ】4167-4768-5446  【四天王クリア】後  【出現ポケモン】アゲハント　バタフリー　カイロス   希望添えませんがもし宜しければ 	neu
 >>36 アニメでソーーナンスッ連呼してるし見た目も覚えやすいから  ちらっとアニメで目に入るだけで印象に残るのかもね 	pos
 >>883  3年くらい前、ﾗﾁﾞｵでピカチュウが気になるって言ってた 	pos
 ごめん、ピカチュウも入れてたから敵のタイプは14種類だ 	neu
 俺の彼女（小野寺結衣）のまとめ  日テレで朝放送中の情報番組ZIP！の  月曜と水曜、金曜日の放送に出演  今日予報担当  現役女子大生  ポケモンファン （ピカチュウやチラーミィ等のかわいい系がすき）  生年月日：1991年8月31日  身長：156cm  血液型：Ｏ型  出身地：アメリカ(シカゴ)  学歴：慶應義塾大学総合政策学部在学中  趣味：グリーティングカード作り、お買物、ネイルアート、アロマ  資格：英検2級、AFS54期生 	pos
 >>476  ギャラドス、ギャロップ、キュウコン、ゴルダック、サイホーン、サワムラー  シャワーズ、ストライク、ドククラゲ、ニドクイン、ニャース、ピカチュウ  まだいたっけ…？  むしろカイリューのがミュウツーの部下感がない  まぁどれ選んでもまず気づかんな  強いて言うならピカかニャースか 	neu
 キラリ朝日キナギタウン  今日も元気かピカチュウ 	neu
 サトシさんもあのピカチュウダンスするんですかね 	neu
 >>213  ピカってそんなに人気あんの? 	neu
 >>77  いや無理だろ  どーゆー計算じゃい 	neg
 マメパト  スボミー  プラスルマイナン  エルフーン  ドレディア  シママ  クルミル  ヒメグマ  ピカチュウ  スワンナ  ママンボウ  ドッコラー 	neu
 >>729メタモン  天井で寝てたんだ･･･  それじゃ、またねメタモンさん   >>731  ･･･そうかな･･･  変わった気はしないよ？  いつものオレだし   >>734ペリッパー  あ、こんにちは  ･･････またね、ペリッパーさん  お疲れ様･･･   >>735  ストライクさん？！  でも･･･違和感なかったし変装じゃないと･･･ 	neu
 >>450  うるさいよ、リサ 	neg
 >>113  気にしなければＯＫ！  足が９０度曲がってようがピカチュウのしっぽみたくなってようが全然ＯＫ！！ 	pos
 「きいろのもり」は、たくさんのピカチュウがすむ、ピカチュウだらけの森だぞ！  普段はお目にかかれない、特別なわざを覚えたピカチュウに出会えるかも!? 	neu
 厳選する意味なさそうならおきがえピカチュウ旅パに突っ込むか 	neu
 ピカチュウえろいな 	pos
 >>537  とりあえず手元にある奴でイーブイはどうですか？ 	neu
 >>65  【自分のフレコ】2852-7662-6931  【出現ポケモン】コクーン、モルフォン、ドラピオン  【備考】登録よろしくお願いします 	neu
 >>573の2番  （ピカチュウ）　もしもライチュウになったら  （ライチュウ）　なにしたいの？  （ピカチュウ）　子供と遊んであげるんだ  （ライチュウ）　やっぱり遊びたいんだ  （ピカチュウ）　でもね　仕事も　ちょっとするよ  （ライチュウ）　フフ、じゃあもしもね、   （ライチュウ）　も一度ピカチュウに戻れたなら  （ピカチュウ）　何したいの？  （ライチュウ）　あってみたい人がいるの  （ピカチュウ）　それって誰なの？  （ライチュウ）　一日だけでも　あえないかな？  （ピカチュウ）　あ、トレーナーだった人だ！  （ライチュウ）　あったりー！   （ライチュウ）　むかし私が　まだピカチュウだったころ  　　　　　　　　　私に　手渡した　一つの雷の石  　　　　　　　　　いまでも　ときどき　トレーナーを思い出すのよ  （ピカチュウ）　トレーナーさんは今はどうしてるの？  （ライチュウ）　さあ、どうでしょうね（涙）   むかしのこども　いまのこども  人気があるのは　いつだって  おとこのこでも　おんなのこでも  だいすきなのは　だれだって　ピカチュウ   ランランランランランララン～♪ 	neu
 >>352  逆じゃんだけど、それってピカチュウもだよ  ピカチュウってアニメ化する前は別に人気無かった（寧ろ御三家、ミュウツー、ミュウ、ピッピあたりのが全然人気あった）  のをアニメの主人公にしたことで国民的なキャラになっちゃったのがピカチュウだよ 	pos
 >>507  は少なくとも人生の負け組み確定 	neg
 京都放送の番組でザ・プラン９の誰かがピカチュウの格好をして  ポケスペ１巻のイワーク戦を朗読してた 	neu
 >>474  進化したら俺は見るのやめるよ 	neg
 野生のピカチュウが出る→でんきだまがくる→ひらいしんとボルテッカー両立→  物理寄り両刀がくる！やったーライチュウちゃん！！ 	pos
 キッドはタケシとピカチュウとゴンベたちとミュウとサトシたちとはじまりの樹に謝れ！ 	neg
 ピカチュウ 	neu
 AG本編で園田氏が脚本書いたピカチュウを連れた青い服の勇者の話は複線だったのか   ・・・とか言ってみる 	neu
 >>213  ありがとうございます！   >>210  登録しました！ 	pos
 >>81  グラードンが弱いんじゃなくて  カイオーガが基地外みたいに強いだけ   ＬＶ４０で四天王に突っ込んでもクリアできるんだから 	pos
 ピカチュウのZ技の元はボルテッカーかな 	neu
 ピカチュウ「ピカピ～♪」  サトシ「なんだよピカチュウ。一緒に寝るか？」  ピカチュウ「ピカピカ！」  サトシ「ははっ。ピカチュウくすぐったいよ」  ピカチュウ「ピカ～！」  サトシ「あっ！…ちょっとピカチュウ…そこはダメだって……あんっ…」    タケシ「あの電気ネズミ…殺す！」 	pos
 >>220  水中シーンは「未来少年コナン」の水中での接吻息継ぎシーンを連想しちまったぜｗ  サトシの場合、相手はピカチュウになりそうだけど、それはそれで萌える   水都で同じシーンがあればラティアスがするんだろうな 	neu
 そんなピカチュウは○○だ 	neu
 >>63  ３歳くらいにさかのぼってママンから言葉を教えてもらえｗ 	neu
 >>590  そう言えばピカ公はまだくっついてるだけだったな 	neu
 >>223  >>1  ポケモン緑・赤・青を最初から始めるスレ２  http://game10.2ch.net/test/read.cgi/poke/1155896531/ 	neu
 571 名前：ゲーム好き名無しさん[sage] 投稿日：2009/06/04(木) 16:48:59 ID:17GAx4a+0  ▼DS「ポケットモンスター ハートゴールド・ソウルシルバー」9月発売決定  9月の発売が正式に決定した模様。  予約キャンペーンの開始は7月4日からで、  特典はすっかりお馴染みとなった海洋堂フィギュア（3種類）   各ソフトには「ポケウォーク」なる歩数計が同梱される  ポケモン絡みの歩数計と言えば、1998年に発売された  「ポケットピカチュウ」を思い出すのだが  「ポケウォーク」の見た目はモンスターボールを模したデザインになっている  仲間にしたポケモンの中から1匹だけを選び出し  DSをプレイしていない時でも行動を共にするらしいのだが  これがソフトにどうフィードバックされていくのかはまだ不明  価格は「ポケウォーク」を同梱して4800円   573 名前：茨城 ◆tdn16sWDX2 [sage] 投稿日：2009/06/04(木) 16:53:55 ID:tqt91fHs0  まじ？ 	neu
 ピカチュウ、ポッチャマ、ルカリオ、サーナイト   ・・・確かに人気ポケモンはみんな二足歩行（ピカチュウは両方） 	pos
 ピカチュウ出るのか？  どうやって出るんだ？ 	neu
 俺もライチュウ派  てか俺昔はピカチュウよりライチュウの方が人気あると思ってた  アニメ始ってからピカチュウの方が人気あることに気づいた 	neu
 新キャラは、ピカチュウと肩を並べる人気のポッチャマしかいないでしょう。 	pos
 >>303  覚えない。他にもそういうやつ結構居る。   >>304  技とかじゃね？知らん。 	neu
 当時はダサいと思ってたピカチュウの3DSLLが今では一番まとも  まぁ、普通のホワイト辺りが持って出るには安定なんですがね 	neg
 ・有料体験版ともいえる詐欺ゲー、初代ポケモンスタジアム   ・金銀発売の度重なる遅延   ・色々な場面におけるピカチュウのゴリ押し   小6の俺は金銀発売を待たずに、ポケモンを見限った。 	neg
 ピカチュウ Lv.78  ラプラス Lv.72  ニンフィア Lv.76  ガブリアス Lv.72  ルカリオ Lv.76  リザードン Lv.78 	neu
 ＞＞346ピカチュウ「よし、吸ってやる、、、ゴホゴホ。くせー」  ニャース「まだまだだなよし俺吸うぜ。ごほごほごほごほ 	neu
 ピカチュウがかみなりパンチつかったお！！！！！！！！！！！！１ 	pos
 >>62  前半には同意 	pos
 >>706  頭悪いなら来るな   >>707  違うが 	neg
 ピカチュウ最強 	pos
 >>984  降りて逃げた 	neg
 >>607  >>609  >>610  >>615  >>639   募居ちゃオフで交換待機しといてくれ   >>647  おまいが早かったらおまいにあげてたｗ  敢闘賞として８時までにまた増やせたらあげるわｗｗｗｗ 	neu
 >>992 キルリアさん  こ、これ全部キルリアさんが？  …すっ、すごいです！なんかとっても尊敬しますよっ！！  えっと、もうお引っ越しみたいなんで  そっちに並べて食べましょう！ぼくも味見したいんで♪   >>994さん  シンオウの辺りでしたっけ？   行ってみたいんですが、そういう機会がありませんねぇ。 	neu
 >>634  そこが非常に悩むところだなー 	neg
 …焼いてくれたのか…ホントにありがとな…  (ピカチュウに頬擦りしたあと肩から降ろす)  ……悪いけど…一旦寝床に戻るよ…片付けなきゃなんないし…  (380がケーキを持って来てくれた箱に、もくたん、ピカチュウの分を切り分けて残ったケーキ(皿に乗ってラップしてある)、わざマシン、  オボンとオレンとモモン数個、なんだかよく分かんないゴムの道具、人間さんのお菓子、シロップ、アチャモドールをなんとか詰め込んだ)  ちょっと重い…(笑)  ……今年いろいろもらえてうれしいなぁーっ♪ 	pos
 >>281  登録しました 	neu
 >>205  じゃあ、違うな。ちょっと待ってくれ、探してくる。 	neu
